                              !                                                                   !888888888888888888888888888888
                              !                                                    h   s          !888888888888888888888888888888
                              !                                                    --------       !888888888888888888888888888888
                              !                                      -------                      !888888888888888888888888888888
                              !                                                                   !888888888888888888888888888888
                              !                           -------                                 !888888888888888888888888888888
                              !                                                                   !888888888888888888888888888888
                              !                     h  c                                          !888888888888888888888888888888
                              !                    ------                   c                     !888888888888888888888888888888
                              !                                                                   !888888888888888888888888888888
                              !                                                                   !888888888888888888888888888888
                              !       -------                        --------                     !888888888888888888888888888888
                              !                                                                   !888888888888888888888888888888
                              !                    s   h                                          !888888888888888888888888888888
                              !                   ---------                                       !888888888888888888888888888888
                              !                                                              g    !888888888888888888888888888888
                              !                                                         -------   !888888888888888888888888888888
                              !                                      s                    -       !888888888888888888888888888888
                              !                                  ---------                -       !888888888888888888888888888888
                              !                     c                                     -       !888888888888888888888888888888
                              !                   ---------                               -       !888888888888888888888888888888
                              !                                                           -       !888888888888888888888888888888
                              !                                                           -       !888888888888888888888888888888
                              !  H         |                 *                  g   /     -      a!888888888888888888888888888888
---------------------------------------------------------------------------------------------------------------------------------
---------------------------------------------------------------------------------------------------------------------------------
---------------------------------------------------------------------------------------------------------------------------------
---------------------------------------------------------------------------------------------------------------------------------
---------------------------------------------------------------------------------------------------------------------------------
---------------------------------------------------------------------------------------------------------------------------------
---------------------------------------------------------------------------------------------------------------------------------
---------------------------------------------------------------------------------------------------------------------------------
---------------------------------------------------------------------------------------------------------------------------------
---------------------------------------------------------------------------------------------------------------------------------
---------------------------------------------------------------------------------------------------------------------------------
---------------------------------------------------------------------------------------------------------------------------------
---------------------------------------------------------------------------------------------------------------------------------