                                      ! g                 h                       h                       !
                                      ! ----          ------            -----     -                       !
                                      !                                                                   !
                                      !                                                  s                !
                                      !                                                 --------          !
                                      !                                                                   !
                                      !                           |       *      /                        !
                                      !                           ----------------                        !
                                      !                                                                   !
                                      !           h  c                                                    !
                                      !           -------                                   h   s         !
                                      !                                            s        ------------- !
                                      !                                                                   !
                                      !                                    h                              !
                                      !------                        --------                             !
                                      !                                                                   !
                                      !                -------                                       g    !
                                      !                                                         -------   !
                                      !        s                                                          !
                                      !     ------                                 --------               !
                                      !                                                                   !
                                      !                   ------                                          !
                                      !                                                                   !
                                      !                                                                   !
                                      !g H              h   c     h       |       *   s     /            a!
        ---------------------------------------------------------------------------------------------------------------------------------
        ---------------------------------------------------------------------------------------------------------------------------------
        ---------------------------------------------------------------------------------------------------------------------------------
        ---------------------------------------------------------------------------------------------------------------------------------
        ---------------------------------------------------------------------------------------------------------------------------------
        ---------------------------------------------------------------------------------------------------------------------------------
        ---------------------------------------------------------------------------------------------------------------------------------
        ---------------------------------------------------------------------------------------------------------------------------------
        ---------------------------------------------------------------------------------------------------------------------------------
        ---------------------------------------------------------------------------------------------------------------------------------
        ---------------------------------------------------------------------------------------------------------------------------------
        ---------------------------------------------------------------------------------------------------------------------------------
        ---------------------------------------------------------------------------------------------------------------------------------