                                             !                                                   h g                      !
                                             !                              g                    ------                  c!
                                             !                            ----                                        ----!
                                             !            |   *   /                                                       !
                                             !            ---------                                                       !
                                             !                                                   |      *  c    /         !
                                             !                   g         |     * g/            ----------------         !
                                             !                             ----------                                     !
                                             !       ---                                                                  !
                                             !                                                                            !
                                             !                        c                                                   !
                                             ! s h                 ------                               s                 !
                                             !----                                                     -----              !
                                             !                                                                            !
                                             !                                          g                                 !
                                             !     s h         c                      ----                          h     !
                                             !     ----      -----                                               -------  !
                                             !                                                                            !
                                             !                                    h                                       !
                                             !                                 -----                                      !
                                             !                       c                                 |   *   g   /      !
                                             !                     -----                               -------------      !
                                             !                                                             -              !
                                             !                                               hc            -              !
                                             !          h   s                   h        --------          -              !
                                             !       --------               ------                         -              !
                                             !                                                             -              !
                                             !                                                             -              !
                                             !  H   |    c *     \    h s |     *     /              s     -             a!
               ----------------------------------------------------------------------------      --------------------------------------------------------
               ----------------------------------------------------------------------------      --------------------------------------------------------
               ----------------------------------------------------------------------------      --------------------------------------------------------
               ----------------------------------------------------------------------------      --------------------------------------------------------
               ----------------------------------------------------------------------------      --------------------------------------------------------
               ----------------------------------------------------------------------------      --------------------------------------------------------
               ----------------------------------------------------------------------------      --------------------------------------------------------
               ----------------------------------------------------------------------------      --------------------------------------------------------
               ----------------------------------------------------------------------------      --------------------------------------------------------
               ----------------------------------------------------------------------------      --------------------------------------------------------
               ----------------------------------------------------------------------------      --------------------------------------------------------
               ----------------------------------------------------------------------------      --------------------------------------------------------
               ----------------------------------------------------------------------------      --------------------------------------------------------